R     1000 1000
NO    /Users/ntomika/Desktop/cub3D(5)(1)/img/bluestone.xpm
SO    ./img/bluestone.xpm
WE    ./img/bluestone.xpm
EA    ./img/bluestone.xpm
S     ./img/bluestone.xpm
F     235,186,52
C     247,238,193


1111111111111111111111
1110000000000000000011
1110000000000000000011
11100000000000S0000011
1110000000000000000011
1110000000000000000011
1111111000000000000011
1110000000000000000011
1110000000000000000011
1110000000000001111111
1110000000000000000011
1111111111111111111111

