R     900 1000
NO    ./img/tex_NO.xpm
SO    ./img/tex_SO.xpm
WE    ./img/tex_WE.xpm
EA    ./img/tex_EA.xpm
S     ./img/barrel.xpm
F     235,186,52
C     181,244,247

1111111111111111111111111
1111111100000000011000001
1011000001110000002000001
1001000000000000000000001
1111111110110000011100001
1000000000110000011101111
1111011111111101110000001
1111011111111101110101001
1100000011010101110000001
1000200000000000110000001
1000000000000000110101001
1100N00111010101111101111
1111111111111111111111111