R  1503 1000
NO    ./img/greystone.xpm
SO    ./img/wood.xpm
WE    ./img/redbrick.xpm
EA    ./img/colorstone.xpm
S     ./img/barrel.xpm
C      228,150,131
F      80,20,20



                  111111111
                 11122222111
                 10020000001
        11111111110200000001111111111
        11000001111000002011110002011
        10200000110020000001100200001
        11000001111000000011110002011
        10000200000000020000002000001
        10000000000000000000000000001
        10000002000000000200000000001
        10000000001000000010000200021
1111111111111111111000000011111111111111111111
1200000001111111111200000211111111110000000021
1200000000000000001000000010000000002000000021
1200020000000000000000N00000000002000000000021
1200000020000020001000000012000000000002000021
1200000001111111111200000211111111112000000021
1111111111111111111000000011111111111111111111
        10000000001000000010000000001
        10000000200000000000000000001
        10000000000002000000000200001
        10000000000000000000000000001
        11000001111000000011110000011
        10000000110000000001100002001
        11020000110000002001102000011
        11111111110000000001111111111
                 10002000001
                 11122222111
                  111111111